"aa" = (/turf/space,/area/space)
"ab" = (/turf/simulated/wall,/area/constructionsite)
"ac" = (/turf/simulated/floor/tiled,/area/constructionsite)
"ad" = (/obj/machinery/light{dir = 1},/turf/simulated/floor/tiled,/area/constructionsite)
"ae" = (/obj/machinery/light{icon_state = "tube1"; dir = 8},/turf/simulated/floor/tiled,/area/constructionsite)
"af" = (/obj/machinery/light{icon_state = "tube1"; dir = 4},/turf/simulated/floor/tiled,/area/constructionsite)
"ag" = (/obj/effect/landmark/start,/turf/simulated/floor/tiled,/area/constructionsite)
"ah" = (/obj/structure/cable{d2 = 2; icon_state = "0-2"; pixel_y = 0},/obj/machinery/power/apc{dir = 8; name = "west bump"; pixel_x = -24},/turf/simulated/floor/tiled,/area/constructionsite)
"ai" = (/obj/structure/cable{d1 = 1; d2 = 2; icon_state = "1-2"; pixel_y = 0},/turf/simulated/floor/tiled,/area/constructionsite)
"aj" = (/obj/structure/cable,/obj/machinery/power/debug_items/infinite_generator,/turf/simulated/floor/tiled,/area/constructionsite)
"ak" = (/obj/machinery/light,/turf/simulated/floor/tiled,/area/constructionsite)
"al" = (/obj/effect/landmark{name = "tdome1"},/turf/simulated/floor/tiled,/area/constructionsite)
"am" = (/obj/machinery/atmospherics/pipe/simple/visible{icon_state = "intact"; dir = 5},/turf/simulated/floor/tiled,/area/constructionsite)
"an" = (/obj/machinery/atmospherics/portables_connector{icon_state = "map_connector"; dir = 8},/obj/machinery/portable_atmospherics/canister/air,/turf/simulated/floor/tiled,/area/constructionsite)
"ao" = (/obj/machinery/atmospherics/pipe/simple/visible{icon_state = "intact"; dir = 4},/turf/simulated/floor/tiled,/area/constructionsite)
"ap" = (/obj/machinery/atmospherics/pipe/simple/visible{icon_state = "intact"; dir = 6},/turf/simulated/floor/tiled,/area/constructionsite)
"aq" = (/obj/machinery/atmospherics/portables_connector{icon_state = "map_connector"; dir = 8},/obj/machinery/portable_atmospherics/canister/empty,/turf/simulated/floor/tiled,/area/constructionsite)
"ar" = (/obj/machinery/atmospherics/unary/vent_scrubber/on{icon_state = "map_scrubber_on"; dir = 1},/turf/simulated/floor/tiled,/area/constructionsite)
"as" = (/obj/machinery/atmospherics/unary/vent_pump/on,/turf/simulated/floor/tiled,/area/constructionsite)
"at" = (/obj/effect/landmark{name = "JoinLate"},/turf/simulated/floor/tiled,/area/constructionsite)
"au" = (/obj/item/artillery_shell,/turf/simulated/floor/tiled,/area/constructionsite)
"av" = (/obj/machinery/light_switch{pixel_x = 25},/turf/simulated/floor/tiled,/area/constructionsite)
"aw" = (/obj/effect/floor_decal/industrial/hatch/yellow,/turf/simulated/floor/tiled,/area/constructionsite)
"ax" = (/obj/structure/ladder/up,/turf/simulated/floor/tiled,/area/constructionsite)
"ay" = (/turf/simulated/wall/iron,/area/shuttle/escape)
"az" = (/obj/effect/wingrille_spawn/reinforced,/turf/simulated/floor/plating,/area/shuttle/escape)
"aA" = (/obj/machinery/computer/shuttle_control{shuttle_tag = "Example"},/turf/simulated/floor/plating,/area/shuttle/escape)
"aB" = (/obj/structure/bed/chair{dir = 1},/obj/machinery/embedded_controller/radio/simple_docking_controller{id_tag = "example_shuttle_starboard"; pixel_x = 28},/obj/machinery/embedded_controller/radio/simple_docking_controller{id_tag = "example_shuttle_port"; pixel_x = -28},/obj/effect/shuttle_landmark/lower_level,/turf/simulated/floor/plating,/area/shuttle/escape)
"aC" = (/obj/machinery/light,/turf/simulated/floor/plating,/area/shuttle/escape)
"aD" = (/obj/machinery/door/airlock/external/bolted{frequency = 1379; id_tag = "example_shuttle_port_hatch"},/turf/simulated/floor/plating,/area/shuttle/escape)
"aE" = (/obj/machinery/door/airlock/external/bolted{frequency = 1379; id_tag = "example_shuttle_starboard_hatch"},/turf/simulated/floor/plating,/area/shuttle/escape)
"aF" = (/obj/machinery/embedded_controller/radio/simple_docking_controller{id_tag = "lower_level_dock"; pixel_x = -8; pixel_y = -25},/turf/simulated/floor,/area/constructionsite)
"aG" = (/obj/machinery/door/airlock/external/bolted{frequency = 1379; id_tag = "lower_level_dock_hatch"},/turf/simulated/floor,/area/constructionsite)
"aH" = (/obj/item/target,/turf/simulated/floor/tiled,/area/constructionsite)
"aI" = (/obj/effect/landmark/test/safe_turf,/turf/simulated/floor/tiled,/area/constructionsite)
"aJ" = (/obj/effect/landmark/test/space_turf,/turf/space,/area/space)
"aK" = (/obj/structure/artillery/base,/turf/simulated/floor/tiled,/area/constructionsite)
"aL" = (/obj/structure/table/steel,/obj/item/clothing/head/helmet/coldwar/pasgt,/obj/item/clothing/head/helmet/coldwar/pasgt/woodland,/obj/item/clothing/head/helmet/coldwar/ssh68,/turf/simulated/floor/tiled,/area/constructionsite)
"aM" = (/obj/structure/table/steel,/obj/item/clothing/suit/storage/vest/vest/a6b5,/obj/item/clothing/suit/storage/vest/a6b44,/turf/simulated/floor/tiled,/area/constructionsite)
"aN" = (/obj/structure/table/steel,/obj/item/clothing/under/rebel,/turf/simulated/floor/tiled,/area/constructionsite)
"aO" = (/obj/structure/window/classic,/turf/simulated/floor/tiled,/area/constructionsite)
"aP" = (/obj/structure/table/steel,/obj/item/weapon/gun/projectile/maka,/turf/simulated/floor/tiled,/area/constructionsite)
"aQ" = (/obj/machinery/light{dir = 1},/obj/structure/table/steel,/turf/simulated/floor/tiled,/area/constructionsite)
"aR" = (/obj/structure/table/steel,/turf/simulated/floor/tiled,/area/constructionsite)
"aS" = (/obj/structure/table/steel,/obj/structure/table/steel,/turf/simulated/floor/tiled,/area/constructionsite)
"aT" = (/obj/machinery/light{icon_state = "tube1"; dir = 8},/obj/item/target,/turf/simulated/floor/tiled,/area/constructionsite)
"aU" = (/obj/machinery/light{icon_state = "tube1"; dir = 4},/obj/structure/table/steel,/turf/simulated/floor/tiled,/area/constructionsite)
"aV" = (/obj/structure/table/steel_reinforced,/turf/simulated/floor/tiled,/area/constructionsite)
"aW" = (/obj/item/weapon/archaeological_find/trap,/turf/simulated/floor/tiled,/area/constructionsite)
"aX" = (/obj/structure/barricade,/turf/simulated/floor/tiled,/area/constructionsite)
"aY" = (/turf/simulated/floor/wood,/area/constructionsite)
"aZ" = (/obj/structure/bed/chair/comfy/beige,/turf/simulated/floor/wood,/area/constructionsite)
"ba" = (/obj/structure/closet/cabinet,/obj/item/weapon/gun/projectile/revolver/wesson32,/turf/simulated/floor/wood,/area/constructionsite)
"bb" = (/obj/structure/bed,/obj/item/weapon/bedsheet,/turf/simulated/floor/wood,/area/constructionsite)
"bc" = (/obj/machinery/light{icon_state = "tube1"; dir = 8},/turf/simulated/floor/wood,/area/constructionsite)
"bd" = (/obj/structure/table/standard,/obj/item/device/radio/phone,/turf/simulated/floor/wood,/area/constructionsite)
"be" = (/obj/structure/table/standard,/obj/item/weapon/material/ashtray,/turf/simulated/floor/wood,/area/constructionsite)
"bf" = (/obj/structure/table/woodentable,/turf/simulated/floor/wood,/area/constructionsite)
"bg" = (/obj/structure/window/classic/reinforced,/turf/simulated/floor/tiled,/area/constructionsite)

(1,1,1) = {"
aaaaaaaaaaaaaaaaaaaaaaaaaaaaaaaaaaaaaaaaaaaaaaaaaaaaaaaaaaaaaaaaaaaaaaaaaaaaaaaaaaaaaaaaaaaaaaaa
aaaaaaaaaaaaaaaaaaaaaaaaaaaaaaaaaaaaaaaaaaaaaaaaaaaaaaaaaaaaaaaaaaaaaaaaaaaaaaaaaaaaaaaaaaaaaaaa
aaaaaaaaaaabababababababababababababababababababababababababababaaaaaaaaaaaaaaaaaaaaaaaaaaaaaaaa
aaaaaaaaaaabacacacadacabacacacacadacacabaHacadaVacacacaPaQaRaSabaaaaaaaaaaaaaaaaaaaaaaaaaaaaaaaa
aaaaaaaaaaabaeababacacacacacabacacacafabaHacacaVacacacacacacaRabaaaaaaaaaaaaaaaaaaaaaaaaaaaaaaaa
aaaaaaaaaaabacabacacacakacacababacabacabaHacacaVacacacacacacaRabaaaaaaaaaaaaaaaaaaaaaaaaaaaaaaaa
aaaaaaaaaaabacacacacacabacacacaOacacacabaTacacaVacacacacacacaUabaaaaaaaaaaaaaaaaaaaaaaaaaaaaaaaa
aaaaaaaaaaababacacacabababacacabacacacabaHacacaVacacacacacacaRabaaaaaaaaaaaaaaaaaaaaaaaaaaaaaaaa
aaaaaaaaaaabacacacacaWabacacacaOacacafabaHacakaVacacacacakacaRabaaaaaaaaaaaaaaaaaaaaaaaaaaaaaaaa
aaaaaaaaaaabaeababacacadacabababacababababababababacababababababaaaaaaaaaaaaaaaaaaaaaaaaaaaaaaaa
aaaaaaaaaaabacacababacacacabacabacabacacacadacacacacacadacacacabaaaaaaaaaaaaaaaaaaaaaaaaaaaaaaaa
aaaaaaaaaaabacacacabacaXababacacacabacalalalacawabawacacacacacabaaaaaaaaaaaaaaaaaaaaaaaaaaaaaaaa
aaaaaaaaaaabacacakacacacacacakacacacacalalalacawawawacacacacavabaaaaaaaaaaaaaaaaaaaaaaaaaaaaaaaa
aaaaaaaaaaabababababababababababababacalalalaxawawawacacacacafabaaaaaaaaaaaaaaaaaaaaaaaaaaaaaaaa
aaaaaaaaaaabaYaYaZaYabbaaYbbabacacacacacacacacacacacacacasacacabaaaaaaaaaaaaaaaaaaaaaaaaaaaaaaaa
aaayayayaaabbcbdbeaYaYaYaYbfabacacacauacacacacacacacacacamaoanabaaaaaaaaaaaaaaaaaaaaaaaaaaaaaaaa
aaazaAazaaabaYaYaYaYabaYaYaYabacacabauaKacacacacagacacacacacacabaaaaaaaaaaaaaaaaaaaaaaaaaaaaaaaa
aaazaBazabababacabbgababababababababacacacacaIacacacacacapaoaqabaaaaaaaaaaaaaaaaaaaaaaaaaaaaaaaa
aaaDaCaEaGaFacacakacacacacacakacacabacacacacacacacacacacaracacabaaaaaaaaaaaaaaaaaaaaaaaaaaaaaaaa
aaayayayababababababababababababababaeacatatatacacacacacacacafabaaaaaaaaaaaaaaaaaaaaaaaaaaaaaaaa
aaaaaaaaaaaaaaaaaaaaaaaaaaaaaaaaaaabahacatatatacacacacacacacacabaaaaaaaaaaaaaaaaaaaaaaaaaaaaaaaa
aaaaaaaaaaaaaaaaaaaaaaaaaaaaaaaaaaabaiacatatatacaLaMaNacacacacabaaaaaaaaaaaaaaaaaaaaaaaaaaaaaaaa
aaaaaaaaaaaaaaaaaaaaaaaaaaaaaaaaaaabajacacakacacacacacakacacacabaaaaaaaaaaaaaaaaaaaaaaaaaaaaaaaa
aaaaaaaaaaaaaaaaaaaaaaaaaaaaaaaaaaabababababababababababababababaaaaaaaaaaaaaaaaaaaaaaaaaaaaaaaa
aaaaaaaaaaaaaaaaaaaaaaaaaaaaaaaaaaaaaaaaaaaaaaaaaaaaaaaaaaaaaaaaaaaaaaaaaaaaaaaaaaaaaaaaaaaaaaaa
aaaaaaaaaaaaaaaaaaaaaaaaaaaaaaaaaaaaaaaaaaaaaaaaaaaaaaaaaaaaaaaaaaaaaaaaaaaaaaaaaaaaaaaaaaaaaaaa
aaaaaaaaaaaaaaaaaaaaaaaaaaaaaaaaaaaaaaaaaaaaaJaaaaaaaaaaaaaaaaaaaaaaaaaaaaaaaaaaaaaaaaaaaaaaaaaa
aaaaaaaaaaaaaaaaaaaaaaaaaaaaaaaaaaaaaaaaaaaaaaaaaaaaaaaaaaaaaaaaaaaaaaaaaaaaaaaaaaaaaaaaaaaaaaaa
aaaaaaaaaaaaaaaaaaaaaaaaaaaaaaaaaaaaaaaaaaaaaaaaaaaaaaaaaaaaaaaaaaaaaaaaaaaaaaaaaaaaaaaaaaaaaaaa
aaaaaaaaaaaaaaaaaaaaaaaaaaaaaaaaaaaaaaaaaaaaaaaaaaaaaaaaaaaaaaaaaaaaaaaaaaaaaaaaaaaaaaaaaaaaaaaa
aJaaaaaaaaaaaaaaaaaaaaaaaaaaaaaaaaaaaaaaaaaaaaaaaaaaaaaaaaaaaaaaaaaaaaaaaaaaaaaaaaaaaaaaaaaaaaaa
aaaaaaaaaaaaaaaaaaaaaaaaaaaaaaaaaaaaaaaaaaaaaaaaaaaaaaaaaaaaaaaaaaaaaaaaaaaaaaaaaaaaaaaaaaaaaaaa
"}
